###########################################################################
#                #        ###            #                                #
#                #        ###            #                                #
#     ######     #   ########            #                                #
#          #              ###            #                                #
#     #    #     #        ###            #                                #
#     ######     #    U                  #                                #
#                #        #######    #####                                #
#                #        #                                               #
#                #        #                                               #
##########   ##############                                               #
#                #        #                                               #
#                #        #                                               #
#     ######     #   ######                                               #
#          #              #                                               #
#          #     #        #                                               #
#                #        #                                               #
#                #        #                                               #
#                #        #                                               #
#                #        #                                               #
######       ##############                                               #
#                #        ###                                              #
#                #        ###                                              #
#     ######     #   ########                                              #
#          #              ###                                              #
#     #    #     #        ###                                              #
#     ######     #    U                                                    #
#                #        ##########################    ####################
#                #        #                                                #
#                #        #                                               #
##########   ##############                                               #
#                #        #                                               #
#                #        #                                               #
#     ######     #   ######                                               #
#          #              #                                               #
#          #     #        #                                               #
#                #        #                                               #
#                #        #                                               #
#                #        #                                               #
###########################################################################
